

NO ./assets/texture_no.xpm
SO ./assets/texture_so.xpm
WE ./assets/texture_we.xpm



EA     ./assets/texture_ea.xpm

F            220         ,       100,0

C 225,30,0

11111111111111 1111111111
10000000001101 1000000001
1011000001110111000000001
1001000000000000000000001
111111111011000001110000000000001
100000000011000001110111111111111
11110111111111011100000010001
11110111111111011101010010001
11000000110101011100000010001
10000000000000001100000010001
10000000S00000001101010010001
10000000000000001101010010001
1100000111010101011101111000111
11110111 1110101 101111010001
11111111 1111111 111111111111