NO ./assets/texture_no.xpm
SO ./assets/texture_so.xpm
WE ./assets/texture_we.xpm

EA ./assets/texture_ea.xpm

F 220 , 100,0

C 35,45,59

 111111111111111111111111 
100000000000000000000001
100000000000000000000001
100000000010000000000001
100000000010000000000001
100000000000000000000001
100000000010000000000001
100000000010000000000001
100001111110000000000001
100000000000000000000001
100000000000000000000001
100000N00000011000000001
100000000000001000000001
100000000000000000000001
100000000000000000000001
100000000000000000000001
100000000000000000000001
100000000000000000000001
100000000000000000000001
100000000000000000000001
100000000000000000000001
100000000000000000000001
111011111111111111111111
1111111111111111111
11111