NO ./assets/texture_no.xpm
SO ./assets/texture_so.xpm
WE ./assets/texture_we.xpm

EA ./assets/texture_ea.xpm

F 220 , 100,0

C 225,30,0

 11111111
111111111111111111111111
100000000000000000000001
100000000000000000000001
100000000010000000000001
100000000010000000000001
100000000000000000000001
100000000010000000000001
100000000010000000000001
100001111110000000000001
100000000000000000000001
100000000000000000000001
100000N00000011000000001
100000000000001000000001
100000000000000000000001
100000000000000000000001
100000000000000000000001
100000000000000000000001
100000000000000000000001
100000000000000000000001
100000000000000000000001
100000000000000000000001
100000000000000000000001
111111101111111111111111
11111