N                       O./assets/texture_no.xpm 
SO                                                                      ./assets/texture_so.xpm
WE ./assets/texture_we.xpm
EA     ./assets/test.xpm

F            220         ,       100,0

C 255,30,0

   11111111111111111111111111111 1111111111
   1000000000000000000000001           111
   1000000000000000000000001           111
   1000000000000000000000001           111
   1000001111100001010100001           111
   1000001000100000000000001           111
   1000001000100001000100001           111
   1000001000100000000000001           111
   1000001101100001010100001           111
   1000000000000000000000001           111
   1000000000000000000000001           111
   1000000000000000000000001     N     111
   1000000000000000000000001           111
   1000000000000000000000001           111
   1000000000000000000000001           111
   1000000000000000100000001           111
   1111111110000001 10000001           111
   1101000010000000100000001           111
   1100001010000000000000001           111
   1101000010000000000000001           111
   1101111110000000000000001           111
   1100000000000000000000001           111
   1111111110000000000000001           111
   1111111110000000000000001           111
   1111111111111111111111111           111