NO ./assets/texture_no.xpm
SO ./assets/texture_so.xpm
WE ./assets/texture_we.xpm
EA ./assets/texture_ea.xpm
F 220,100,0
C 225,30,0

1111111
11111
1111111111111111111111111111111111
1000000000000000000000011111111111
100000000000000000000001 1 1 1 1 1
100000000010000000000001 1 1 1 1 1
100000000010000000000001 1 1 1 1 1
100000000000000000000001 1 1 1 1 1
100000000010000000000001 1 1 1 1 1
100000000010000000000001 1 1 1 1 1
100001111110000000000001 1 1 1 1 1
100000000000000000000001 1 1 1 1 1
100000000000000000010101 1 1 1 1 1
100000N00000011000000001 1 1 1 1 1
100000000000001000000001 1 1 1 1 1
100000000000000000000001 1 1 1 1 1
100000000000000000000001 1 1 1 1 1
100000000000000000000001 1 1 1 1 1
100000000000000000000001 1 1 1 1 1
100000000000000000000001 1 1 1 1 1
100000000000000000000001 1 1 1 1 1
100000000000000000000001 1 1 1 1 1
100000000000000000000001 1 1 1 1 1
100000000000000000000001 1 1 1 1 1
111111111111111111111111 1 1 1 1 1
111111
111