	
NO ./assets/textureno.xpm
SO ./assets/textureso.xpm
WE ./assets/texturewe.xpm



EA     ./assets/textureea.xpm

F            220         ,       100,0

C 225,30,0

	
111111111111111111111111111111111111111
100000000000000000000000111111111111111
100000000000000000000000111111111111111
100000000000000000000000111111111111111
100000111110000101010000111111111111111
100000100010000000000000111111111111111
100000100010000100010000111111111111111
100000100010000000000000111111111111111
100000110110000101010000111111111111111
100000000000000000000000111111111111111
100000000000000000000000111111111111111
100000000000000000000000111111111111111
100000000000N00000000000111111111111111
100000000000000000000000111111111111111
100000000000000000000000111111111111111
100000000000000000000000111111111111111
111111111000000000000000111111111111111
110100001000000000000000111111111111111
110000101000000000000000111111111111111
110100001000000000000000111111111111111
110111111000000000000000111111111111111
110000000000000000000000111111111111111
111111111000000000000000111111111111111
111111111000000000000000111111111111111
111111111111111111111111111111111111111