NO ./assets/texture_no.xpm
SO ./assets/texture_so.xpm
WE ./assets/texture_we.xpm

EA ./assets/texture_ea.xpm

F 220 , 100,0

C 35,45,59

11111111
111110111111111111111111111111111111111
100000000000000000000000111111111111101
100000000000000000000000111111111111111
100000000000000000000000111111111111111
100000111110000101010000111111111111111
100000100010000000000000111111111111111
100000100010000100010000111111111111111
100000100010000000000000111111111111111
100000110110000101010000111111111111111
100000000000000000000000111111111111111
100000000000000000000000111111111111111
100000000000000000000000111111111111111
100000000000N00000000000111111111111111
100000000000000000000000111111111111111
100000000000000000000000111111111111111
100000000000000000000000111111111111111
11111111000000000000000111111111111111
110100001000000000000000111111111111111
110000101000000000000000111111111111111
110100001000000000000000111111111111111
110111111000000000000000111111111111111
110000000000000000000000111111111111111
111111111000000000000000111111111111111
111111111000000000000000111111111111111
101111111111111111111111111111111111111
111